11111111111111111111111111111
10000000000000000000000000001
10000000000000000000000000001
10000000000000000000000000001
10000000110000000001100000001
10001000110000000001100010001
10001000000000000000000010001
10001000000000000000000010001
10001000000000000000000010001
10001000000000000000000010001
10001000000000000000000010001
10001000000000000000000010001
10001000000000000000000010001
10001000000000000000000010001
10001000000000000000000010001
10001000000000000000000010001
10001000000000000000000010001
10001000000000000000000010001
10001000000000000000000010001
10001000000000000000000010001
10001000000000000000000010001
10001000000000000000000010001
10001000000000000000000010001
10001000110000000001100010001
10000000110000000001100000001
10000000000000000000000000001
10000000000000000000000000001
10000000000000000000000000001
11111111111111111111111111111
